[
	06, 06, 06, 06, 06, 06, 06, 06,
	  06, -1, -1, -1, -1, -1, 06, -1,
	06, -1, -1, 05, 03, 04, 02, 05,
	  06, -1, -1, -1, 01, 03, 03, -1,
	06, -1, -1, -1, -1, -1, 03, 05,
	  05, 00, -1, -1, -1, -1, -1, -1,
	03, 00, 01, 05, -1, -1, -1, -1,
	  04, 00, 00, 05, 00, -1, -1, -1,
	-1, -1, -1, -1, -1, -1, -1, -1,
	  -1, -1, -1, -1, -1, -1, -1, -1,
	-1, -1, -1, -1, -1, -1, -1, -1,
	  -1, -1, -1, -1, -1, -1, -1, -1,
]
